#####
#   ###
#G#c  #
# scC #
#  c  #
##G#G##
 #   #
 #####