#####
#   ##
# c  #
## c ####
 ###sG  #
  #  G# #
  #     #
  #######