 ######
##    #
#  ## #
# # c #
#  C G#
## #s##
 #   #
 #####
