####
#  ###
# cc #
#GGG #
# sc #
#   ##
#####