  ######
###    #
#  C##G#
# #G  G#
# c c  #
##c#c#s#
 #    G#
 #######