 ######
##  G #
# C # #
# Gc  #
#  #c##
## s #
 #####