   ####
   # s##
####   #
#G #cc #
#     ##
#G  c##
##G  #
 #####