########
#G   G #
# # #  #
#sc  cG#
##### c#
    #  #
    ####