 #####
 # s ###
## G   #
#G cGc #
##c# ###
 #   #
 #####