#####
#  G###
# cGG #
#  ##c##
##  #  #
 #c   s#
 #  ####
 ####