   ####
 ### s#
##GccG#
#  c ##
# # G#
# c G#
######