   #####
 ###   #
## c #c##
# c GGG #
# # s # #
# GGG c #
##c# c ##
 #   ###
 #####