  ######
 ##    #
## G  c##
# CG c  #
#   CsC #
######C #
     #  #
     ####