  #####
###   #
# cG#c##
# c  cS#
#  GG ##
##c#G #
 #   ##
 #####