#####  ####
#s  ####  #
# c CG c  #
## #GG #  #
# c GC #  #
#   # c  ##
#####  ###
    ####