  ######
  #s   #
 ##c##c##
## G G  #
#   GccG#
#   ##  #
#########