##########
#        #
#  #GcG# #
# cC # C #
##scC C  #
 ##  G ###
  ######