#######
#sC G #
#Cc cC#
# cG  #
#     #
# GcG #
#######