   ######
 ###    #
##sc Gc #
# c  c# #
#G  # G ###
######cGc #
     #G  G#
     ######