###########
#      #s #
# ## #c#  #
# #GC  cc #
# #GG#c# ##
#  GG  #  #
# # #  c  #
#      #  #
###########