 #####
 #   ####
 #   #  #
 ##    G#
### ###G#
# c # #G#
# cc# ###
#s  #
#####