########
#   #  #
# # #cG#
#    cG#
# # #cG#
#   #  #
#####s #
    ####