 ####
###  #
#s Gc##
#   c #
# #G  #
#     #
#######