########
#G   c #
#Gc  # #
#G# #  #
### # ##
 # c  #
 #s ###
 ####