  #####
###   #
# c # ##
# cGcG #
# ##G  #
#  s ###
######