  ####
###  ##
#   c #
# #G#s#
# #c G#
#  Gc #
##   ##
 #####